10 10
0010000000
0010000000
0000011000
0000000000
0000000300
0000111100
0000002000
0000000000
0000000000
0000000000
2 1 6 4