16 16
0100000000100000
0010000000100000
0101020000100000
0001000000011010
0001000000000000
0300000000000010
0100010000010000
0000010000000000
0000010000000000
0000010000000000
0000010000000000
0000010000000000
0000010000000000
0000010000000000
0000010000000000
0000010000000000
