16 16
1111111111111111
1000000000000001
1020000000000001
1000000000000001
1000111111110001
1000100000010001
1000100000010001
1000100000010001
1000111111110001
1000000000000001
1030000000000001
1000000000000001
1111111111111111
0000000000000000
0000000000000000
1111111111111111
2 2 6 6
