32 32
00000010000000000000000000000000
00000010000000000000000000020000
00000010000000000000000111111111
00000010000000000000000000000000
00000011111111111110000000000000
00000000000000000010000000000000
00000000000000000010000000000000
00000000000000000000000000000000
00000000000000000000000000000000
00000000000000000000000000000000
00000000000000000010000000000000
00000000000000000010000000000000
00000000000000000010000000000000
00000300000000000010000000000000
00000000000000000010000000000000
00000000000000000010000000000000
00000000000000000010000000000000
00000000000000000010000000000000
00000000000000000010000000000000
00000000000000000010000000000000
00000000000000000010000000000000
00000000000000000010000000000000
00000000000000000010000000000000
00000000000000000010000000000000
00000000000000000010000000000000
00000000000000000010000000000000
00000000000000000010000000000000
00000000000000000010000000000000
00000000000000000010000000000000
00000000000000000010011111111000
00000000000000000012000000000000
00000000000000000011111111111111
22 0 24 3
10 0 13 3