32 32
00000000000000000001000000000000
00000000000000000001000000000000
00000000111111000001000000003000
00000200100000000001000000000000
11111111100000000001000000000000
00000000000000000001000000000000
00300000000000000001000000000000
00000000000000000000000000000000
00000000000000000000000000000000
00000000111111111111111000000000
00000000000000000000001000000000
00000000000000000000001000000000
00000000000000000000001000000000
00000000100000000000001000000000
00000000100000000000001000000000
00000000100000000000001111110000
00000000100000000000000000000000
00000000111111111111111100000000
00000000100000000000000000000000
00000000100000000010000000000000
00000000102111111111111000000000
00000000100100000010000000000000
00000111111100020010000000000000
00000000000000000010000000000000
00000000000000000010002000000000
00000000000000000010000000000000
00000000111111111111111000000000
00000000000000000000000000000000
00000000000000000000000000000200
00300000111111111111111000000000
00000000100000000000000000000000
00000000100000000000000000000000
0 20 2 22