32 32
30000000000000000001000000000000
00000000000000000001000000000000
00000000111111000001000000000000
00000000100000000001000000000000
11111111100000000001000000000000
00000000000000000001000000000000
00000000000000000001000000000000
00000000000000000000000000000000
00000000000000000000000000000000
00000000111111111111111000000000
00000000000000000000001000000000
00000000000000000000001000000000
00000000000000000000001000000000
00000000100000000000001000000000
00000000100000000000001200000000
00000000100000000000001111110000
00000000100000000000000000000000
00000000111111111111111100000000
00000000100000000000000000000000
00000000100000000010000000000000
00000000100111111111111000000000
00000000120100000010000000000000
00000111111100000010000000000000
00000000000000000010000000000000
00000000000000000010000000000000
00000000000000000010000000000000
00000000111111111111111000000000
00000000000000000000000000000000
00000000000000000000000000000000
00000000111111111111111000000000
00000000100000000000000000000000
00000000100000000000000000000000
0 20 2 22