32 32
03300000000000000000000000000000
00000000000000000000000000000200
00000000000000000000000000000000
00000011111111111111111111000000
00000000000000000000001000000000
00000000000000000000001000000000
00000000000000000000001000000000
11111111111111100000001000000000
00000000000000000000001000000000
00000000000000000000001000000000
00000000000000000000000000000000
00000000000000000000000000000000
00000011111111111111111111110000
00000010000000000000000000000000
00000010000000000000000000000000
00000010000000000010000000000000
00000010000022000010000000002000
00000020000000000010000000000000
00200010000000000000000000020000
00000010000000000000000000000000
00000010000111111111111111000000
00000010000100000000000000000100
00000010000100000000000000000100
00000011111111111111000000000100
00000000000001000000000000000100
00000000000001000000000000000100
00000000000001000000000000000100
00020000000001000000002200000100
00000000000000020000000000000000
00000000000000000000000000000000
00000000000000000000000000000000
00000000000000000000000000000000
29 12 31 14