32 32
03000000000000000000000000000000
00000000000000000000000000000000
00000000000000000000000000000000
00000011111111111111111111000000
00000000000000000000001000000020
00000000000000000000001000000000
00200000000000000000001000000000
11111111111111100000001000000000
00220000000000000000001000000000
00000000000000000000001000000000
00000000000000000000000000000000
00000000000000000000000000000000
00000011111111111111111111110000
00000010000000000000000000000000
00000010000000000000000000000000
00000010000000000010000000000000
00000010000000000010000000000000
00000000000000000010000000000000
00000010000000000000000000000000
00000010000000000000000000000000
00000010000111111111111111000000
00000010000100000000000000000100
00000010000120000000000000000100
00000011111111111111000000000100
00000000000001000000000000000100
00000000000001000000000000000100
00000000000001000000000000000100
00000000000001000000000000000100
00000000000000000000000000000000
00000000000000000000000000000000
00000000000000000000000000000000
00000000000000000000000000000000
29 12 31 14