32 23
00000000000000000000001000000000
00000000000000100000001000000100
00000010000000100000001000000100
00000210000000100000001000000111
11111111111111100000001000000000
00010000000000000000001000000000
00010000000000000000001002000000
00010000111100000111111000000000
00010000000100000100001111000000
00010000000100000100000001000000
00000000000100000100000001000000
00000000000100000100000001000000
00000000000000000100100001000000
00000000000000000100100001000000
00000000000001111111100001000000
00111100000001000000000001110000
00100120000001000000000000000000
00101111111111000000000000000000
00100000000000000000000000000000
00100000000000000111111110000000
00100001111000000100000010000000
00000001001000000102000010000000
00000001001001000100000010100000
00000001111001000100000000100000
00011100000001000111111111100000
00000100000201000000000000000100
00000111111111000000000000000100
00000000000001000000000000000100
00000000000001000000000000000100
00000000000001000011111110000100
11111111000001000010000000000100
00003000000001200010000000000100
30 15 31 16