32 32
30000000000000000000000000000000
00111111111111111111111111111110
00010000000000000000000000100010
01110000111111111111100000101110
01011100000000000100000100000010
01010100000000000100000100000010
01010100000011111111111111100010
00010111110010000000000000000010
11110100000010000000000000010010
00000000000010000000000000010010
20000000000010111111111110010010
01110111111110000000001000110010
00010000000010000000001000000010
11010000111110111111001001110010
01011100100010100001001000100010
01001000100010120001001001111110
01001000100010000001001001000010
01111000000111111111001111001010
00001000000100000001001000001010
11101000111111100111111001111010
00101000100000000000000001000010
01100000100000000000001001000010
01000001111111111111001111100000
01000001000000000000000000000000
01001111011111001111111100000010
01001001010000001000000100011110
01001001010000001000100100010000
00000001010011101111100100010110
00201111010010000000100100010210
00000000010010000000100100010010
00111100010011111000100100011110
00000100000010000000000100000000